John Bythewall - friend - stomv@live.com
Liam Black - friend - smpeters@outlook.com
Olivia Miller - school - draper@aol.com
Oliver Anderson - friend - pavel@live.com
Emma Flores - family - sblack@att.net
Charlotte Johnson - friend - dgatwood@outlook.com
Noah Cook - school - gommix@comcast.net
Amelia Baker - friend - iapetus@verizon.net
Sophia Johnson - friend - peterhoeg@me.com
James Williams - school - dkasak@icloud.com
Elijah Jones - school - gward@verizon.net
Dylan King - school - bmidd@me.com
Mia Davis - friend - yamla@optonline.net
Mateo Reyes - family - jamuir@optonline.net
Theodore Wilson - school - wsnyder@aol.com
Henry Taylor - friend - north@optonline.net
Lucas Flores - family - hager@icloud.com
Isabela Hernandez - family - oechslin@live.com
William Jackson - friend - nanop@sbcglobal.net
Benjamin Moore - school - howler@mac.com
Ava Garcia - family - sarahs@optonline.net
Levi Davis - school - skoch@sbcglobal.net
Evelyn Jones - friend - matthijs@live.com
Sebastian Martinez - family - lishoy@gmail.com
Ezra Thompson - school - jshearer@yahoo.ca
Jack Lopez - family - muadip@aol.com
David Allen - school - hmbrand@mac.com
Timoteo Reys - family - skajan@yahoo.ca
Juan Reys - family - jginspace@mac.com
Michael Rodriguez - family - gozer@mac.com
Daniel Reys - family - jespley@me.com
Leo Lopez - family - thurston@icloud.com
Noah Cook - school - gommix@comcast.net
Hudson Moore - friend - webteam@hotmail.com
Lluvia Reys - family - slanglois@icloud.com
Henry Taylor - friend - north@optonline.net
Owen Thomas - school - jorgb@icloud.com
Samuel Lee - school - spadkins@live.com
Asher Harris - friend - rohitm@att.net
Harper White - school - fmerges@icloud.com
Alexander Clark - school - kevinm@att.net
Luca Lewis - school - nweaver@msn.com
Clark Kent - friend - emmanuel@comcast.net
Luna Sanchez - family - grothoff@outlook.com
Ethan Robinson - friend - dowdy@mac.com
Sofia Walker - friend - msusa@live.com
John Young - school - presoff@mac.com
Camila Walker - friend - demmel@verizon.net
Logan Wright - school - wildfire@verizon.net
Dylan King - school - hakim@outlook.com
David Allen - school - hmbrand@mac.com
Batman null - family - imbatman@icloud.com
Twilight Sparkle - friend - pavel@outlook.com
George Smith - school - barjam@hotmail.com
Joseph Fielding - family - yenya@att.net
Miss America - friend - boser@mac.com
Green Hall - school - phizntrg@live.com
Joe Hisaishi - family - jdray@gmail.com